"Year","Tows","All_Fish","Sexed_Fish","Unsexed_Fish","Sample_Size"
2003,197,2837,2833,4,589
2004,212,3346,3345,1,674
2005,278,4555,4539,16,907
2006,247,3668,3664,4,753
2007,257,3409,3403,6,727
2008,254,3037,3032,5,673
2009,273,3375,3373,2,739
2010,322,6018,6015,3,1152
2011,320,6176,6172,4,1172
2012,295,5372,5366,6,1036
2013,218,3445,3440,5,693
2014,332,4822,4805,17,997
2015,312,4236,4232,4,897
2016,309,4385,4383,2,914
2017,314,4261,4260,1,902
2018,291,3783,3782,1,813
